10 3 7 -1 10 1 3 1 3 7 
2 4 9 10 6 11 9 10 5 9 
2 2 -1 2 4 7 10 9 -1 -1 
2 8 3 6 8 5 5 7 10 14 
4 1 0 9 -1 -1 12 4 6 -1 
4 7 4 14 10 3 5 6 2 -1 
4 6 8 7 8 5 3 9 4 7 
2 2 4 9 -1 -1 8 7 8 9 
4 2 8 7 -1 -1 10 5 7 -1 
8 5 1 5 1 1 5 14 8 14 
