10 3 3 1 14 -1 10 3 1 3 3 7 -1 -1 -1 10 1 1 3 14 
8 5 0 1 14 -1 4 9 11 5 0 5 14 -1 -1 8 1 7 2 -1 
10 3 5 3 14 -1 2 12 11 7 2 10 14 -1 -1 11 7 2 2 -1 
2 8 14 2 10 14 2 4 1 9 4 5 14 -1 -1 11 5 9 4 7 
4 1 1 5 9 -1 2 8 7 12 2 10 1 7 -1 -1 10 1 6 2 
8 3 7 -1 10 7 2 -1 4 9 4 9 10 6 11 1 6 -1 8 6 
12 13 2 -1 2 2 8 1 6 12 8 1 9 2 12 10 6 -1 -1 13 
4 7 4 3 6 8 3 7 8 9 10 7 -1 2 4 5 5 7 -1 -1 
2 2 2 4 0 7 13 8 1 1 5 6 -1 2 13 -1 -1 8 3 14 
8 5 0 5 0 6 -1 -1 -1 -1 11 5 7 8 7 10 1 3 6 -1 
-1 -1 8 3 5 9 10 1 7 -1 -1 -1 2 -1 2 8 7 4 5 7 
10 3 7 8 1 3 5 1 9 -1 -1 10 9 -1 8 7 2 13 11 6 
4 5 5 1 1 6 -1 -1 -1 -1 -1 2 12 -1 -1 8 6 10 7 2 
2 -1 -1 -1 -1 8 1 3 7 -1 -1 4 6 -1 -1 -1 2 2 4 9 
2 12 10 3 1 7 10 9 8 7 -1 4 9 12 -1 11 6 4 5 14 
4 6 4 6 10 9 8 7 12 2 -1 2 12 8 7 -1 2 2 10 7 
13 8 5 14 2 10 1 9 2 2 -1 2 4 7 2 -1 13 8 6 13 
12 12 10 1 5 9 -1 10 5 9 -1 2 4 9 8 7 -1 -1 8 7 
4 5 9 11 3 7 -1 8 3 14 -1 8 6 10 7 2 -1 -1 -1 2 
8 1 1 1 5 9 11 1 5 14 -1 -1 8 5 5 5 1 1 1 9 
